########
# J    #
####P###
#T     #
######P#
#MT #  #
#T  P  #
#S M# M#
########