########
# J    #
####P###
#T     #
######P#
#M  #  #
#   P  #
#S  #  #
########